#######
#@ FG #
#  B X#
#    X#
#F G X#
#   $ #
#######
