########
#    $ #
#@     #
#  XX  #
#@     #
#      #
#M     #
########
