########
#@     #
# X    #
# 1    #
# X    #
# X    #
# X   $#
########
